{1,0,0,0,3,0,0,0,0,1}
{2,0,0,0,2,3,0,0,1,0}
{0,0,0,0,0,2,0,0,0,0}
{1,0,0,1,0,6,0,0,0,0}
{0,0,0,0,0,0,0,0,0,0}
{1,0,0,0,0,0,0,0,0,0}
{0,0,0,0,2,3,0,0,0,0}
{0,0,0,0,3,0,0,0,0,0}
{0,0,0,0,0,0,0,1,0,0}
{0,0,0,0,0,0,0,0,0,5}
name=Four Corners
next=10 Introduction.txt
prev=8 Out on a Limb.txt
score=18
goal=18
message_left=
message_right=
locked=false