{0,0,0,1,0,0,1,0}
{0,9,0,0,0,0,0,0}
{1,0,0,0,0,0,0,0}
{0,0,0,0,0,0,0,3}
{0,0,0,0,0,0,0,2}
{0,0,0,0,0,9,0,0}
{1,0,0,0,6,0,0,0}
{5,0,0,0,0,0,0,0}
name=Level 21
next=Level 22.txt
prev=Level 20.txt
score=26
message_left=
message_right=
link=2,2->6,6
link=6,6->2,2
