{0,0,0,0,0,1,7,1,0,0}
{0,1,0,0,0,0,0,0,9,0}
{0,0,0,0,0,0,0,3,0,4}
{0,0,0,0,2,0,0,0,0,0}
{1,0,0,3,0,2,0,0,0,0}
{0,0,0,0,3,0,0,0,0,0}
{0,0,0,0,0,0,0,0,1,0}
{0,0,0,0,1,0,0,0,0,0}
{0,0,0,0,0,0,0,0,0,0}
{0,0,0,0,0,0,0,0,0,5}
name=Level 8
next=Level 9.txt
prev=Level 7.txt
score=21
message_left=
message_right=
link=7,1->9,2
