{0,7,0,0,0,0,2,0,0,0}
{0,0,0,0,0,0,0,0,0,0}
{0,0,0,3,0,0,2,0,0,0}
{0,0,0,0,0,0,12,0,0,3}
{1,1,1,1,1,1,1,1,1,1}
{1,0,0,0,3,4,0,0,0,3}
{1,0,0,0,0,2,1,0,0,0}
{1,3,0,0,0,0,0,0,0,0}
{1,4,0,0,2,0,0,0,0,0}
{10,0,0,0,0,2,4,1,0,5}
next=Level 1.txt
prev=Level 12.txt
score=999
name=Level 13
link=2,1->1,10
rail=10,4->7,4
rail=7,4->7,1
rail=7,1->4,1
rail=4,1->4,4
rail=4,4->5,4
rail=5,4->5,3
rail=5,3->1,3
rail=1,3->1,1
rail=1,1->2,1