{0,7,0,0,0,0,0,0,0,0}
{0,0,0,0,0,0,0,0,0,0}
{0,0,0,0,0,0,0,0,0,0}
{0,0,0,0,0,0,0,0,0,12}
{1,1,1,1,1,1,1,1,1,1}
{0,0,0,0,0,0,0,0,0,10}
{0,0,0,0,0,0,0,0,0,0}
{0,0,0,0,0,0,0,0,0,0}
{0,0,0,0,0,0,0,0,0,0}
{0,12,0,0,0,0,0,0,0,5}
next=Level 1.txt
prev=Level 12.txt
score=999
name=Level 13
link=2,1->10,6
rail=2,10->6,10
rail=10,4->7,4
rail=7,4->7,1
rail=7,1->4,1
rail=4,1->4,4
rail=4,4->5,4
rail=5,4->5,3
rail=5,3->1,3
rail=1,3->1,1
rail=1,1->2,1