{0,0,0,0,0,0,0,0}
{0,0,0,0,9,0,0,0}
{5,1,0,0,0,0,0,0}
{1,0,0,0,0,0,2,0}
{7,0,0,0,0,0,0,0}
{1,0,0,0,0,2,0,0}
{3,0,0,0,2,3,0,0}
{0,0,0,0,3,0,0,0}
name=Switch
next=Level 6.txt
prev=Level 4.txt
score=20
message_left=
message_right=
link=1,5->5,2
locked=false
