{3,3,3,2,0,0,0,2,2}
{0,3,0,2,1,0,1,3,0}
{0,2,3,3,0,2,0,2,3}
{1,1,2,3,7,0,2,2,0}
{3,0,1,1,0,1,1,0,1}
{0,0,2,0,2,0,3,2,0}
{3,2,3,1,0,9,0,0,0}
{2,2,0,0,2,0,2,0,0}
{0,0,2,1,5,1,3,0,3}
name=Level 7
next=Level 8.txt
prev=Level 6.txt
score=28
message_left=
message_right=
link=5,4->6,7
