{1,1,1,1,0,0,0,1,1,1,1}
{1,1,1,0,1,1,1,0,1,1,1}
{1,1,1,0,1,1,1,0,1,1,1}
{1,1,1,0,1,1,1,0,1,1,1}
{1,1,1,0,1,1,1,0,1,1,1}
{1,1,0,0,0,0,0,0,0,1,1}
{1,1,0,1,1,1,1,1,0,1,1}
{1,1,0,1,1,0,1,1,0,1,1}
{1,1,0,1,1,0,1,1,0,1,1}
{1,1,0,1,1,1,1,1,0,1,1}
{1,1,0,0,0,0,0,0,0,1,1}
name=Locked
next=null.txt
prev=null.txt
score=999
message_left=
message_right=
