{0,0,0,0,0,0,0,0,0,0}
{0,0,0,0,0,3,0,0,0,0}
{0,0,0,3,0,0,0,0,0,0}
{0,0,0,0,0,0,0,3,0,0}
{0,0,0,2,6,2,0,0,0,0}
{0,0,0,0,2,0,0,1,0,0}
{0,0,0,0,0,0,2,0,0,0}
{0,0,2,0,0,0,0,1,0,0}
{0,0,0,0,0,0,3,0,0,0}
{0,0,3,0,0,0,5,0,0,0}
next=Level 5.txt
prev=Level 3.txt
score=999
name=Level 4
