{0,0,0,0,0,0,0,0,0,0}
{0,0,0,0,0,0,0,0,0,0}
{0,0,0,0,0,0,0,0,0,0}
{0,0,0,0,3,0,0,0,0,0}
{5,1,0,2,0,0,0,0,0,0}
{1,0,0,0,0,0,0,0,3,0}
{7,0,0,0,0,0,0,0,0,0}
{1,0,0,0,0,0,0,10,0,0}
{0,0,0,0,2,3,0,0,0,0}
{0,0,0,0,0,0,0,0,0,0}
next=Level 6.txt
prev=Level 4.txt
score=999
