{0,0,0,0,0,1,7,1,0,0}
{0,1,0,0,0,0,0,0,10,0}
{0,0,0,0,0,0,0,3,0,4}
{0,0,0,0,2,0,0,0,0,0}
{1,0,0,3,0,2,0,0,0,0}
{0,0,0,0,3,0,0,0,0,0}
{0,0,0,0,0,0,0,5,1,0}
{0,0,0,0,1,0,0,0,0,0}
{0,0,0,0,0,0,0,0,0,0}
{0,0,0,0,0,0,0,0,0,0}
next=Level 1.txt
prev=Level 5.txt
score=999
name=Level 6
link=7,1->9,2
