{
    "info": {
        "levelName": "Level 4",
        "nextLevelName": "Level 1",
        "prevLevelName": "Level 3",
        "size": 12
    },
    "data": [
    	1,1,1,1,1,1,1,1,1,1,1,1,
    	1,0,0,0,0,0,0,0,0,0,0,1,
		1,0,0,0,0,0,5,0,0,0,0,1,
		1,0,0,0,5,0,0,0,0,0,0,1,
		1,0,0,0,0,0,0,0,5,0,0,1,
		1,0,0,0,4,3,4,0,0,0,0,1,
		1,0,0,0,0,4,0,0,1,0,0,1,
		1,0,0,0,0,0,0,4,0,0,0,1,
		1,0,0,4,0,0,0,0,1,0,0,1,
		1,0,0,0,0,0,0,5,0,0,0,1,
		1,0,0,5,0,0,0,2,0,0,0,1,
		1,1,1,1,1,1,1,1,1,1,1,1
    ]
}
